000***0********
*S**0*0*000*00*
0*0000**00*000*
***********0***
00000000000000*
***************
*0000*000000000
****0*000******
000*0***0*00*0*
****0*000*0**0*
*000000***0*00*
********000*00*
*0000000****00*
*0000000000000*
****0*G********
