OOO***O********
*P**O*O*OOO*OO*
O*OOOO**OO*OOO*
***********O***
OOOOOOOOOOOOOO*
***************
*OOOO*OOOOOOOOO
****O*OOO******
OOO*O***O*OO*O*
****O*OOO*O**O*
*OOOOOO***O*OO*
********OOO*OO*
*OOOOOOO****OO*
*OOOOOOOOOOOOO*
****O*G********